TTTTTTTTTTTTTTTTTTTTTT
T      TTTTTTTT      T
T                    T
T      RRRRRRRR      T
T                    T
T                    T
T    TTT             T
T                    T
T                    T
T        TTTT   A    T
T               P    T
T                    T
TTTTTTTTTTTTTTTTTTTTTT
